25 21 21 21 21 21 21 21 21 21 21 21 21 21 21 21 21 21 21 21 21 21 21 21 21 21 21 21 21 21 21 21 21 21 21 21 21 21 21 21 21 21 21 21 21 21 21 21 21 21 21 21 21 21 21 21 21 21 21 21 21 21 21 21 21 21 21 21 21 21 21 21 21 21 21 21 21 21 21 26
13 1 1 1 1 1 1 1 1 1 1 1 1 1 1 1 1 1 1 1 1 1 1 1 1 1 1 1 1 1 1 1 1 1 1 1 1 1 1 1 1 1 1 1 1 1 1 1 1 1 1 1 1 1 1 1 1 1 1 1 1 1 1 1 1 1 1 1 1 1 1 1 1 1 1 1 1 1 1 14
13 1 34 22 22 22 22 22 22 22 22 22 22 22 22 22 22 22 22 22 22 22 22 22 22 22 22 22 22 22 22 22 22 22 22 22 22 22 22 22 22 22 22 22 22 22 22 22 22 22 22 22 22 22 22 22 22 22 22 22 22 22 22 22 22 22 22 22 22 22 22 22 22 22 22 22 22 33 1 14
13 1 14 0 0 0 0 0 0 0 0 0 0 0 0 0 0 0 0 0 0 3 3 3 3 0 0 0 0 3 3 0 0 0 0 0 0 0 0 0 0 0 0 0 0 0 0 0 0 0 0 0 0 0 0 0 0 0 0 0 0 0 0 0 0 0 0 0 0 0 0 0 0 0 0 0 0 13 1 14
13 1 14 0 4 0 0 0 0 0 0 0 0 0 0 0 0 0 0 0 0 0 0 0 0 0 3 3 0 0 0 3 0 0 0 0 0 0 0 0 0 0 0 0 0 0 0 0 0 0 0 0 0 0 0 0 0 0 17 19 19 19 19 18 0 0 0 0 0 0 0 0 0 0 0 4 0 13 1 14
13 1 14 0 0 0 0 0 0 0 0 0 0 0 0 0 0 0 0 0 0 3 17 19 19 19 19 19 19 18 0 0 0 0 0 0 0 0 0 3 0 0 0 0 0 3 0 0 0 0 0 0 0 0 0 0 0 0 11 2 2 2 2 12 0 0 0 0 0 0 0 0 0 0 0 0 0 13 1 14
13 1 14 0 0 0 0 0 0 0 0 0 0 0 0 0 0 0 0 0 3 17 27 2 2 2 2 2 2 12 0 0 0 0 0 0 0 0 0 0 0 0 0 0 0 0 0 0 0 0 0 3 0 0 0 0 0 0 11 2 2 2 2 12 0 0 0 0 0 0 0 0 0 0 0 0 0 13 1 14
13 1 14 0 0 0 0 0 0 0 0 0 0 0 0 0 0 0 0 0 17 27 2 2 2 2 2 2 2 12 0 0 0 0 0 0 0 0 0 0 0 0 0 0 0 0 0 0 0 0 0 0 0 0 0 0 0 0 11 2 2 2 2 12 0 0 0 0 0 0 0 0 0 0 0 0 0 13 1 14
13 1 14 0 0 0 0 0 0 0 0 0 0 0 0 0 0 0 17 19 27 2 2 2 2 2 2 2 2 12 0 0 0 0 0 0 0 0 0 0 0 0 0 0 0 0 0 0 0 0 0 0 0 0 0 0 0 0 11 2 2 2 2 12 0 0 0 0 0 0 0 0 0 0 0 0 0 13 1 14
13 1 14 0 0 0 0 0 0 0 0 0 0 0 0 0 0 0 11 2 2 2 2 2 2 2 2 2 2 12 0 0 0 0 0 0 0 0 0 0 0 0 0 0 0 0 0 0 0 0 0 0 0 0 0 0 0 0 11 2 2 2 2 12 0 0 0 0 0 0 0 0 0 0 0 0 0 13 1 14
13 1 14 0 0 0 0 0 0 0 0 0 0 0 0 0 0 0 11 2 2 2 2 2 2 2 2 2 30 16 0 0 0 0 0 0 0 3 0 0 0 0 0 0 0 0 0 0 0 0 0 0 0 0 0 0 0 0 11 2 2 2 2 12 0 0 0 0 0 0 0 0 0 0 0 0 0 13 1 14
13 1 14 0 0 0 0 0 0 0 0 0 0 0 0 0 0 0 11 2 2 2 2 2 2 2 2 2 12 0 0 0 0 0 0 0 0 0 0 0 0 0 0 0 0 0 0 0 0 0 0 0 3 0 0 0 0 0 11 2 2 2 2 12 0 0 0 0 0 0 0 0 0 0 0 0 0 13 1 14
13 1 14 3 3 0 3 3 3 3 3 3 3 3 3 3 3 0 15 29 2 2 2 2 2 2 2 30 16 0 0 0 0 0 0 0 0 0 0 0 0 0 0 0 0 0 0 0 0 0 0 0 0 0 0 0 0 17 27 2 2 2 2 12 0 0 0 0 0 0 0 17 19 19 19 18 0 13 1 14
13 1 14 3 3 0 3 3 3 3 3 3 3 3 3 3 3 0 0 15 29 2 2 2 2 2 30 16 3 0 0 0 0 0 0 0 0 0 0 0 0 0 0 0 3 0 0 0 0 0 0 0 0 0 0 0 0 11 2 2 2 2 30 16 0 0 0 0 0 17 19 27 2 2 2 12 0 13 1 14
13 1 14 3 3 0 3 3 3 3 3 3 3 3 3 3 3 3 0 0 11 2 2 2 2 30 16 0 0 0 0 0 0 0 0 0 0 0 0 0 0 0 0 0 0 0 0 0 0 0 0 0 0 0 0 0 17 27 2 2 2 2 12 0 0 0 0 17 19 27 2 2 2 2 30 16 0 13 1 14
13 1 14 3 3 0 3 3 3 3 3 3 3 3 3 3 3 3 3 0 11 2 2 2 2 12 0 0 0 0 0 0 0 0 0 0 0 0 0 0 0 0 0 0 0 0 0 0 0 0 0 0 0 0 0 0 11 2 2 2 2 2 12 17 19 19 19 27 2 2 2 2 2 2 12 0 0 13 1 14
13 1 14 3 3 0 3 3 3 3 3 3 3 3 3 3 3 3 3 0 15 29 2 2 2 12 0 0 0 0 0 0 0 0 0 0 0 0 0 0 0 0 0 0 0 0 0 0 0 0 0 0 0 0 0 0 11 2 2 2 2 2 28 27 2 2 2 2 2 2 2 2 30 20 16 3 0 13 1 14
13 1 14 3 3 0 0 3 3 3 3 3 3 3 3 3 3 3 3 0 0 11 2 2 2 12 0 0 0 0 3 0 0 0 0 0 0 0 0 0 0 3 0 0 0 0 0 0 0 0 0 0 0 0 0 0 11 2 2 2 2 2 2 2 2 2 2 2 2 2 30 20 16 3 3 3 0 13 1 14
13 1 14 3 3 3 0 3 3 3 3 3 3 3 3 3 3 3 3 3 0 11 2 2 2 12 0 0 0 0 0 0 0 0 0 3 0 0 0 0 0 0 0 0 0 0 0 0 0 0 0 0 0 0 0 0 11 2 2 2 2 2 2 2 2 2 30 20 20 20 16 0 3 3 3 0 0 13 1 14
13 1 14 3 3 3 0 0 3 3 3 3 3 3 3 3 3 3 3 3 0 11 2 2 2 28 18 0 0 0 0 0 0 0 0 0 0 0 0 0 0 0 0 0 0 0 0 0 0 0 0 0 0 0 0 0 11 2 2 2 2 2 2 30 20 20 16 0 0 0 0 0 0 0 0 0 0 13 1 14
13 1 14 3 3 3 3 0 3 3 3 3 3 3 3 3 3 3 3 3 0 11 2 2 2 2 12 0 0 0 0 0 0 0 0 0 0 0 0 0 0 0 0 0 0 0 0 0 0 0 0 0 0 0 3 17 27 2 2 2 2 2 30 16 0 0 0 0 0 0 0 0 0 0 0 0 0 13 1 14
13 1 14 3 3 3 3 0 0 3 3 3 3 3 3 3 3 3 3 3 0 15 29 2 2 2 12 0 0 0 0 0 0 0 0 0 0 0 0 0 0 0 0 0 0 0 0 0 0 0 0 0 0 0 0 11 2 2 2 2 2 30 16 0 0 0 0 0 35 5 5 5 5 5 5 9 0 13 1 14
13 1 14 3 3 3 3 3 0 3 3 3 3 3 3 3 3 3 3 3 0 0 11 2 2 2 28 18 0 0 0 0 0 0 0 0 0 0 0 0 0 0 0 0 0 0 0 3 0 0 0 0 0 0 0 11 2 2 2 2 2 12 0 0 0 0 0 0 0 0 0 0 0 0 0 6 0 13 1 14
13 1 14 3 3 3 3 3 0 3 3 3 3 3 3 3 3 3 3 3 3 0 15 29 2 2 2 28 18 0 0 0 0 0 0 0 0 0 0 0 0 0 0 0 0 0 0 0 0 0 0 0 0 0 0 11 2 2 2 2 2 12 0 0 0 0 0 0 0 0 0 38 0 0 0 6 0 13 1 14
13 1 14 3 3 0 0 0 0 0 3 0 0 0 3 3 3 3 3 3 3 0 0 11 2 2 2 2 12 0 0 0 0 0 0 0 0 0 0 3 0 0 0 0 0 0 0 0 0 0 0 0 0 0 0 11 2 2 2 2 30 16 0 0 35 5 5 5 5 36 0 6 0 0 0 6 0 13 1 14
13 1 14 3 3 0 3 3 3 0 0 0 0 0 0 0 0 3 3 3 3 3 0 11 2 2 2 2 12 0 0 0 0 0 0 0 0 0 0 0 0 0 0 0 0 0 0 0 0 0 0 0 0 0 0 11 2 2 2 2 12 0 0 0 0 0 0 0 0 0 0 6 0 0 0 0 0 13 1 14
13 1 14 3 3 0 3 3 3 3 3 0 0 0 3 3 0 3 3 3 3 3 0 11 2 2 2 2 12 0 3 0 0 0 0 0 0 0 0 0 0 0 0 0 0 0 0 0 0 0 0 0 0 0 17 27 2 2 2 2 12 6 0 0 0 0 6 0 0 0 0 37 0 0 0 0 0 13 1 14
13 1 14 3 3 0 3 3 3 3 3 3 3 3 3 3 0 3 3 3 3 3 0 15 29 2 2 2 12 0 0 0 0 0 0 0 0 0 0 0 0 0 0 0 0 0 0 0 0 0 0 0 0 0 11 2 2 2 2 2 12 6 0 0 0 0 6 0 0 0 0 0 0 0 0 0 0 13 1 14
13 1 14 3 3 0 3 3 3 3 3 3 3 3 3 3 0 3 3 3 3 3 0 0 11 2 2 2 28 18 0 0 0 0 0 0 0 0 0 0 0 0 0 0 0 0 0 0 0 0 0 0 3 0 11 2 2 2 2 2 12 6 0 0 0 0 6 0 0 0 0 0 0 38 0 0 0 13 1 14
13 1 14 3 3 3 3 3 3 3 3 3 3 3 3 3 0 3 3 3 3 3 3 0 11 2 2 2 2 12 0 0 0 0 0 0 3 0 0 0 0 0 0 0 0 0 0 0 0 0 0 0 0 0 11 2 2 2 2 30 16 6 0 0 0 0 6 0 0 0 0 0 0 6 0 0 0 13 1 14
13 1 14 3 3 3 3 3 3 3 3 3 3 3 3 3 0 3 3 3 3 3 3 0 15 29 2 2 2 12 0 3 0 0 0 0 0 0 0 0 0 0 0 0 0 0 0 0 0 3 0 0 0 0 11 2 2 2 2 12 0 6 0 0 0 0 6 0 0 0 6 0 0 6 0 0 0 13 1 14
13 1 14 3 3 3 3 3 3 3 3 3 3 3 3 3 0 3 3 3 3 3 3 0 0 11 2 2 2 12 0 0 0 0 0 0 0 0 0 0 0 0 0 0 0 0 0 0 0 0 0 0 0 0 11 2 2 2 2 12 0 8 5 5 0 0 6 0 0 0 6 0 0 6 0 0 0 13 1 14
13 1 14 3 3 3 3 3 3 3 3 3 3 3 3 3 0 3 3 3 3 3 3 3 0 11 2 2 2 28 18 0 0 0 0 0 0 0 0 0 0 0 0 0 0 3 0 0 0 0 0 0 0 17 27 2 2 2 2 12 0 0 0 0 0 0 6 0 0 0 6 0 0 6 0 0 0 13 1 14
13 1 14 3 3 3 3 3 3 3 3 3 3 3 3 0 0 3 3 3 3 3 3 3 0 11 2 2 2 2 28 18 0 0 0 0 0 0 0 0 0 0 0 0 0 0 0 0 0 0 0 0 17 27 2 2 2 2 30 16 0 0 0 0 0 0 0 0 0 0 6 0 0 6 0 0 0 13 1 14
13 1 14 3 3 3 3 3 3 3 3 3 3 3 3 0 3 3 3 3 3 3 3 3 0 15 29 2 2 2 2 28 18 0 0 0 0 0 3 0 0 0 0 0 0 0 0 0 0 0 0 17 27 2 2 2 2 30 16 0 0 0 0 0 0 0 0 6 0 0 0 0 0 6 0 0 0 13 1 14
13 1 14 3 0 0 0 0 0 0 0 0 0 0 0 0 3 3 3 3 0 3 0 3 0 0 11 2 2 2 2 2 28 19 19 19 19 19 19 19 19 18 0 17 19 19 19 19 19 19 19 27 2 2 2 2 30 16 0 0 0 0 0 0 0 0 0 37 0 0 0 0 0 6 0 0 0 13 1 14
13 1 14 3 3 3 3 3 3 3 3 3 3 3 3 3 3 0 3 0 3 0 3 0 0 0 15 29 2 2 2 2 2 2 2 2 2 2 2 2 2 12 0 11 2 2 2 2 2 2 2 2 2 2 2 30 16 6 0 0 0 7 5 5 5 36 0 38 0 7 5 5 5 10 0 0 0 13 1 14
13 1 14 3 0 3 3 3 3 0 0 0 3 3 0 0 3 3 0 3 0 0 3 3 0 0 0 15 29 2 2 2 2 2 2 2 2 2 2 2 2 12 0 11 2 2 2 2 2 2 2 2 2 2 30 16 0 6 0 0 0 6 0 0 0 0 0 6 0 6 0 0 0 0 0 0 0 13 1 14
13 1 14 0 0 0 3 3 0 0 3 0 0 0 3 3 0 0 3 0 3 0 0 0 3 0 0 0 15 29 2 2 2 2 2 2 2 2 2 2 2 12 0 11 2 2 2 2 2 2 2 2 2 30 16 0 0 6 0 0 0 6 0 0 0 38 0 6 0 6 0 0 0 0 0 0 0 13 1 14
13 1 14 0 3 3 0 0 0 3 0 0 0 3 0 0 0 0 0 3 0 0 0 0 0 0 0 0 0 15 20 20 20 20 20 20 20 20 20 20 20 16 0 15 20 20 20 20 20 20 20 20 20 16 0 0 0 6 0 0 0 6 0 0 0 37 0 37 0 8 5 5 5 5 5 5 36 13 1 14
13 1 14 0 0 0 0 0 3 0 0 3 0 0 0 3 0 0 0 3 0 3 0 3 0 0 3 0 0 0 38 0 0 0 0 0 0 0 0 0 0 0 0 0 0 0 0 0 0 0 0 0 38 0 0 0 0 6 0 0 0 6 0 0 0 6 0 0 0 0 6 0 0 0 0 0 0 13 1 14
13 1 14 0 0 0 0 0 0 0 0 0 0 0 0 0 0 0 0 0 0 0 0 0 0 0 0 0 0 7 10 0 0 0 0 0 0 0 0 0 0 0 0 0 0 0 0 0 0 0 0 0 6 0 0 0 0 8 5 5 5 5 36 0 35 5 5 5 5 5 10 0 0 0 0 0 0 13 1 14
13 1 14 0 0 0 0 0 0 0 0 0 0 0 0 0 0 0 0 0 0 0 0 0 0 0 0 0 7 10 0 0 0 0 0 0 0 0 0 0 0 0 0 0 0 0 0 0 0 0 0 0 6 0 0 0 0 0 0 0 0 0 0 0 0 0 0 0 0 0 0 0 0 0 0 0 0 13 1 14
13 1 14 0 0 0 0 0 0 0 0 0 0 0 0 0 0 0 0 0 0 0 0 0 0 0 0 7 10 0 0 0 0 0 0 3 0 0 0 0 0 0 0 0 0 0 0 0 0 0 0 0 8 5 5 5 5 5 5 5 5 5 5 5 5 5 5 5 5 5 5 5 5 5 5 36 0 13 1 14
13 1 14 0 0 0 0 0 0 0 0 0 0 0 0 0 0 0 0 0 0 0 0 0 0 0 7 10 0 0 0 0 0 0 0 0 0 0 0 0 0 0 0 0 0 0 0 0 0 0 0 0 0 0 0 0 0 0 0 0 0 0 0 0 0 0 0 0 0 0 0 0 0 0 0 0 0 13 1 14
13 1 14 0 0 0 0 0 0 25 21 21 21 21 21 21 21 26 0 25 21 21 21 21 21 26 37 0 0 0 0 0 0 0 0 0 0 0 0 0 0 0 0 0 0 0 0 0 0 0 0 0 0 0 0 0 0 0 0 0 0 0 0 0 0 0 0 0 0 0 0 0 0 0 0 0 0 13 1 14
13 1 14 0 0 0 0 0 0 13 1 1 34 22 33 1 1 14 0 13 1 1 1 1 1 32 21 26 0 0 0 0 0 0 0 0 0 0 0 0 3 0 0 0 0 0 0 0 0 0 0 0 0 0 3 0 0 0 0 0 0 0 0 0 0 0 0 0 0 0 0 0 0 0 0 0 0 13 1 14
13 1 14 0 0 0 0 0 0 13 1 34 24 0 23 22 22 24 0 13 1 1 1 1 1 1 1 14 0 0 0 0 0 0 0 0 0 0 0 0 0 0 0 0 0 0 0 0 0 0 0 0 0 0 0 0 0 0 0 0 0 0 0 0 0 0 0 0 0 0 0 0 0 0 0 0 0 13 1 14
13 1 14 0 0 0 0 0 0 13 1 14 0 0 0 0 0 0 0 13 1 1 1 1 1 1 1 14 0 0 0 0 0 0 0 0 0 0 0 0 0 0 0 0 0 0 0 0 0 0 0 0 0 0 0 0 0 0 0 0 0 3 0 0 0 0 0 0 0 0 0 0 0 0 0 0 0 13 1 14
13 1 14 0 0 0 0 0 0 13 1 32 26 0 25 21 21 26 0 23 22 22 22 22 22 33 1 14 0 0 0 0 0 0 3 0 0 0 0 0 0 0 0 0 3 0 0 0 0 0 0 0 0 0 0 0 0 0 0 0 0 0 0 0 0 0 0 0 0 0 0 0 0 0 0 0 0 13 1 14
13 1 14 0 0 0 0 0 0 13 1 1 32 21 31 1 1 14 0 0 0 0 0 0 0 0 13 14 0 0 0 0 0 0 0 0 0 0 0 0 0 0 0 0 0 0 0 0 0 0 0 0 0 0 0 0 0 0 0 0 0 0 0 0 0 0 0 0 0 0 0 0 0 0 0 0 0 13 1 14
13 1 14 0 0 0 0 0 0 13 1 1 1 1 1 1 1 1 0 1 1 26 0 1 0 0 13 14 0 0 0 0 0 0 0 0 0 0 0 0 0 0 0 0 0 0 0 0 0 0 0 0 0 0 0 0 0 0 0 0 0 0 0 0 0 0 0 0 0 0 0 0 0 0 0 0 0 13 1 14
13 1 14 0 0 0 0 0 25 31 1 1 1 1 34 24 0 0 0 1 1 14 0 1 1 0 13 14 0 0 0 0 0 0 0 0 0 0 0 0 0 0 0 0 0 0 0 0 0 0 0 0 0 0 0 0 0 3 0 0 0 0 0 0 0 0 0 0 0 0 0 3 0 0 0 0 0 13 1 14
13 1 14 0 0 0 0 25 31 1 1 1 1 34 24 0 0 1 0 1 1 14 0 1 1 0 13 32 26 0 0 0 0 0 0 0 0 0 0 0 0 0 0 0 0 0 0 0 0 0 0 0 0 0 0 0 0 0 0 0 0 0 0 0 0 0 0 0 0 0 0 0 0 0 0 0 0 13 1 14
13 1 14 0 0 0 25 31 1 1 1 1 1 14 0 0 1 0 0 0 1 14 0 1 1 0 23 33 32 26 0 0 0 0 0 0 0 0 0 0 0 0 0 0 0 0 0 0 0 0 0 0 0 3 0 0 0 0 0 0 0 0 0 0 0 0 0 0 0 0 3 0 0 0 0 0 0 13 1 14
13 1 14 0 0 0 13 1 1 1 1 1 1 14 0 1 1 0 0 0 1 14 0 1 1 0 0 13 1 32 26 0 0 0 0 0 0 0 5 5 5 0 0 0 0 0 0 0 0 0 0 0 0 0 0 0 0 0 0 0 0 0 0 0 0 0 0 0 0 0 0 0 0 0 0 0 0 13 1 14
13 1 32 21 26 0 13 1 1 1 1 1 1 14 0 1 1 0 0 0 1 14 0 1 1 1 0 23 33 1 32 26 0 0 0 0 0 6 0 0 0 6 0 0 0 0 3 0 0 0 0 0 0 0 0 0 0 0 0 0 0 0 0 0 0 0 0 0 0 0 0 0 0 0 0 0 0 13 1 14
13 1 1 1 14 0 13 1 1 1 1 1 34 24 0 1 1 1 1 1 1 14 0 1 1 1 0 0 23 33 1 32 26 0 0 0 0 6 0 4 0 6 0 0 0 0 0 0 0 0 0 0 0 0 0 0 0 0 0 3 0 0 0 0 0 0 0 0 0 0 0 0 0 0 0 0 0 13 1 14
13 1 1 1 14 0 13 1 1 1 1 34 24 0 0 1 1 1 1 1 1 14 0 1 1 1 26 0 0 13 1 1 14 0 0 0 0 6 0 0 0 6 0 0 0 0 0 0 0 0 0 0 0 0 0 0 0 0 0 0 0 0 0 0 0 0 0 0 0 0 0 0 0 3 0 0 0 13 1 14
13 1 1 1 14 0 13 1 1 34 22 24 0 0 1 1 34 22 22 22 22 24 0 1 1 1 32 26 0 13 1 1 14 0 0 0 0 0 1 0 1 0 0 0 0 0 0 0 0 0 0 0 0 0 0 0 0 0 0 0 0 0 0 0 0 0 3 0 0 0 0 0 0 0 0 0 0 13 1 14
13 1 1 1 14 0 13 1 1 14 0 0 0 1 1 14 0 0 0 0 0 0 0 0 0 0 0 1 0 13 1 1 14 0 0 0 0 0 0 0 0 0 0 0 0 0 0 0 0 0 0 0 3 0 0 0 0 0 0 0 0 0 0 0 0 0 0 0 0 0 0 0 0 0 0 0 0 13 1 14
13 1 1 1 14 0 23 33 1 14 0 1 1 1 1 14 0 1 1 1 1 1 1 1 1 1 0 1 0 13 1 1 14 0 0 0 0 0 0 0 0 0 0 0 0 0 0 0 0 0 0 0 0 0 0 0 0 0 0 0 0 0 0 0 0 0 0 0 0 0 0 0 0 0 0 0 0 13 1 14
13 1 1 1 14 0 0 23 22 24 0 1 1 1 1 14 0 1 1 1 1 1 1 1 1 1 0 1 0 13 1 1 14 0 0 0 0 0 0 0 0 0 0 0 0 0 0 0 0 0 0 0 0 0 0 0 0 0 0 0 0 0 0 0 0 0 0 0 0 0 0 0 0 0 0 0 0 13 1 14
13 1 1 1 32 26 0 0 0 0 0 1 1 1 1 14 0 1 1 1 1 1 1 1 1 1 0 1 0 13 1 1 14 0 0 0 0 0 0 0 0 0 0 0 0 0 0 0 0 0 0 0 0 0 0 0 0 0 3 0 0 0 0 0 0 17 19 19 18 0 17 19 19 18 0 0 0 13 1 14
13 1 1 1 1 32 21 21 21 26 0 1 1 1 1 14 0 1 1 1 1 1 14 0 0 0 0 1 0 13 1 1 14 0 0 0 0 0 0 0 0 0 0 0 0 0 0 0 0 0 3 0 0 0 0 0 0 0 0 0 0 0 0 0 17 27 2 2 28 19 27 2 2 28 18 0 0 13 1 14
13 1 1 1 1 1 1 1 34 24 0 1 1 1 1 31 0 1 1 1 1 1 14 0 25 21 21 1 0 13 1 1 14 0 0 0 0 0 0 0 0 0 0 0 0 0 0 0 0 0 0 0 0 0 0 0 0 0 0 0 0 0 0 0 11 2 2 2 2 2 2 2 2 2 12 0 0 13 1 14
13 1 1 1 34 22 22 22 24 0 0 0 0 0 1 14 0 1 1 1 1 1 14 0 13 1 1 14 0 13 1 1 14 0 0 0 0 0 0 0 0 0 3 0 0 0 0 0 0 0 0 0 0 0 0 0 0 0 0 0 0 0 0 0 11 2 2 2 2 2 2 2 2 2 12 0 0 13 1 14
13 1 1 1 14 0 0 0 0 0 13 1 1 1 1 14 0 1 1 1 1 1 14 0 13 1 1 14 0 13 1 1 14 0 0 0 0 0 0 0 0 0 0 0 0 0 0 0 0 0 0 0 0 0 0 0 0 0 0 0 0 0 0 0 11 2 2 2 2 2 2 2 2 2 12 0 0 13 1 14
13 1 1 1 14 0 25 21 21 21 31 1 1 1 1 14 0 23 22 22 22 22 24 0 13 1 1 14 0 13 1 1 14 0 0 0 0 0 0 0 0 0 0 0 0 0 0 0 0 0 0 0 0 0 0 0 0 0 0 0 3 0 0 0 15 29 2 2 2 2 2 2 2 30 16 0 0 13 1 14
13 1 1 1 14 0 13 1 1 1 1 1 1 1 1 14 0 0 0 0 0 0 0 0 13 1 1 14 0 13 1 1 14 0 0 0 0 0 0 0 0 0 0 0 0 0 0 0 0 0 0 0 0 0 3 0 0 0 0 0 0 0 0 0 0 15 29 2 2 2 2 2 30 16 0 0 0 13 1 14
13 1 1 1 14 0 13 1 1 1 1 1 1 1 1 32 21 21 21 21 21 21 21 21 31 1 1 14 0 13 1 1 14 0 0 0 0 0 0 0 0 0 0 0 0 0 0 0 0 0 0 0 0 0 0 0 0 0 0 0 0 0 0 0 0 0 15 29 2 2 2 30 16 0 0 0 0 13 1 14
13 1 1 1 14 0 23 22 22 22 22 0 0 0 1 1 1 1 1 1 1 1 1 1 1 1 1 14 0 13 1 1 14 0 0 0 0 0 0 0 0 0 0 0 0 0 0 0 0 0 0 0 0 0 0 0 0 0 0 0 0 0 0 0 0 0 0 15 29 2 30 16 0 0 0 0 0 13 1 14
13 1 1 1 14 0 0 0 0 0 0 0 0 0 1 1 1 1 1 1 1 1 1 1 1 1 1 14 0 13 1 1 14 0 0 0 3 0 0 0 0 0 0 0 3 0 0 0 0 0 0 0 0 0 0 0 0 0 0 0 0 0 0 0 0 0 0 0 15 20 16 0 0 0 0 0 0 13 1 14
13 1 1 1 32 21 21 21 21 21 21 0 0 0 1 1 1 1 1 1 1 1 1 1 1 1 1 14 0 13 1 1 14 0 0 0 0 0 0 0 0 0 0 0 0 0 0 0 0 0 0 0 0 0 0 0 0 0 0 0 0 0 3 0 0 0 0 0 0 0 0 0 0 0 0 0 0 13 1 14
13 1 1 1 34 22 22 22 22 22 22 22 22 22 22 22 22 22 22 22 22 22 22 22 22 22 22 24 0 23 22 22 24 0 0 0 0 0 0 0 0 0 0 0 0 0 0 0 0 0 0 0 0 0 0 0 0 0 0 0 0 0 0 0 0 0 0 0 0 0 0 0 0 0 0 0 0 13 1 14
13 1 1 1 4 0 0 0 0 0 0 0 0 0 0 0 0 0 0 0 0 0 0 0 0 0 0 0 0 0 0 0 0 0 0 0 0 0 0 0 0 0 0 0 0 0 0 0 0 0 0 0 0 0 0 0 0 0 0 0 0 0 0 0 0 0 0 0 0 3 0 0 0 0 0 4 0 13 1 14
13 1 1 1 32 21 21 21 21 21 21 21 21 21 21 21 21 21 21 21 21 21 21 21 21 21 21 21 21 21 21 21 21 26 0 0 0 0 0 0 0 0 0 0 0 0 0 0 0 0 0 0 0 0 0 0 0 0 0 0 0 0 0 0 0 0 0 0 0 0 0 0 0 0 0 0 0 13 1 14
13 1 1 1 1 1 1 1 1 1 1 1 1 1 1 1 1 1 1 1 1 1 1 1 1 1 1 1 1 1 1 1 1 32 21 21 21 21 21 21 21 21 21 21 21 21 21 21 21 21 21 21 21 21 21 21 21 21 21 21 21 21 21 21 21 21 21 21 21 21 21 21 21 21 21 21 21 31 1 14
13 1 1 1 1 1 1 1 1 1 1 1 1 1 1 1 1 1 1 1 1 1 1 1 1 1 1 1 1 1 1 1 1 1 1 1 1 1 1 1 1 1 1 1 1 1 1 1 1 1 1 1 1 1 1 1 1 1 1 1 1 1 1 1 1 1 1 1 1 1 1 1 1 1 1 1 1 1 1 14
23 22 22 22 22 22 22 22 22 22 22 22 22 22 22 22 22 22 22 22 22 22 22 22 22 22 22 22 22 22 22 22 22 22 22 22 22 22 22 22 22 22 22 22 22 22 22 22 22 22 22 22 22 22 22 22 22 22 22 22 22 22 22 22 22 22 22 22 22 22 22 22 22 22 22 22 22 22 22 24